1111111111111111111111
1000000000000000010001
1000000110000000010001
1000100101010000100001
1000P000000000000000C1
101001C0000000000000C1
1000000000000010001001
100000C10000000E000101
1000000000010000010001
1100000000000000000001
1000000001000000000001
1000010000000000000011
1000000000000000000001
1000010000000000000001
10000100000110C0000001
1111111111111111111111